1    1
1    1
1    1
1    1
1    1
1    1
1    1
1    1
1    1
1    1
1    1
1    1
1    1
1    1
1    1
1    1
1    1
1    1
1    1
1    1
1    1
1    1
1    1
1    1
1    1
1    1
1    1
1    1
1    1
1    1
1    1
1    1
1    1
1    1
1    1
1    1
1                   1
1                  1 
1 P               111                                 
111111111111111111111111111111111111111111111111111111111111111111111111111111111111111111111111111111111111111111111111111111111111111111111111111111111111111111111111111111111111111111111111111111111111111111111111111111111111111111111111111111111111111111111111111111
