0
0
0
0
0
0
0
0
0
0
0
0
0
0
0,0,0,0,0,0,0,0,0,0,0,0,0,0,0,0,0,0,0,0,0,0,0,0,-10
0,0,0,0,0,0,0,-11,0,0,0,0,0,0,a,0,0,0,0,-10,-10,0,-10,15,9
0,0,0,0,0,0,15,9,16,-10,0,0,-11,0,0,-11,0,0,0,15,9,9,9,17,13
0,0,0,15,9,9,17,12,18,9,9,9,9,9,9,9,9,9,9,17,12,12,12,13,14
0,15,9,17,13,13,12,12,12,12,12,12,12,12,12,12,12,12,12,12,14,14,14,14,27
9,17,12,13,13,12,12,12,13,13,14,14,14,14,14,14,14,14,14,14,27,27,27,27,27,24
14,14,14,14,14,14,14,14,14,14,27,27,27,27,27,27,27,27,27,27,27,24,24,24,24,24,24,24,24
27,27,27,27,27,27,27,27,27,27,27,27,24,24,24,24,24,24,24,24,24,24,24,24,24,24,24,24,24,24
