11
101100000000000000001
100011000000000000001
100000110000000000001
100000000000000010001
100000000000000010001
100000000000000010001
100000000000000010001
100000000000000010001
100000000000000010001
100000000000000010001
100000000000000010001
100000000000000010001
100000000000000010001
100000000000000010001
100000000000000010001
100000000000000010001
100000000000000010001
100000000000000010001
100000000000000010001
100000000000000010001
100000000000000010001
100000000000000010001
100000000000000010001
100000000000000000001
100000000000000000001                   11111
100000000000000000001
10000000000000000000                    11
10000000000000000000           2       1111
11111111111111111111111111111111111111111111111111111111111111111