






1    1
1    1
1    1
1    1
1    1
1    1
1    1
1    1
1    1
1    1
1    1
1    1
1                   1
1                   1 
12                  111
1111111111111111111111111111111111