


1    1
1    1
1    1
1    1
1    1
1    1
1    1
1    1
1    1
1    1
1    1
1    1
1    1
1    1
1    1
1    1
1    1
1    1
1    1
1    1
1    1
1    1
1    1
1    1
1    1
1    1
1    1
1    1
1    1
1    1
1    1
1    1
1    1
1    1
1    1
1    1
1                   1
1                   1 
12                  111                                 
111111111111111111111111111111111111111111111111111111111111111111111111111111111111111111111111111111111111111111111111111111111111111111111111111111111111111111111111111111111111111111111111111111111111111111111111111111111111111111111111111111111111111111111111111111