0
0
0
0
0
0
0
0
0
0
0
0
0
0
0
0
0
0
0
0
0
0
0
0
0
0
0,0,0,0,0,0,0,0,0,0,0,0,0,0,0,0,0,0,0,0,0,0,-25,-26,-24,-24,-24,-24,-24,-27,-28
0,0,0,0,0,0,0,0,0,0,0,0,0,0,0,0,0,0,0,0,0,0,0,22,30,21,21,21,30,23
0,0,0,0,0,0,0,0,0,0,0,0,0,0,0,0,0,0,0,0,0,0,0,-22,-30,-21,-30,-21,-30,-23,0,0,0,0,0,0,0,0,-25,-26,-24,-24,-24,-24,-24,-24,-27,-28
0,0,22,21,21,21,21,21,23,0,0,0,0,0,0,0,0,0,0,0,0,0,0,0,-20,0,0,0,-20,0,0,0,0,0,0,0,0,0,0,22,30,21,30,30,21,30,23
0,0,22,30,21,21,21,30,23,0,0,0,0,0,0,0,0,0,0,0,0,0,0,0,-20,0,0,0,-20,0,0,0,0,0,0,0,0,0,0,22,30,21,21,21,21,30,23
0,0,0,20,0,0,0,-20,0,0,0,0,0,0,0,0,0,0,0,0,0,0,0,0,-20,0,0,0,-20,0,0,0,0,0,0,0,0,0,0,0,-20,0,0,0,0,20
0,0,0,20,0,0,0,-20,0,0,0,0,0,0,0,0,0,0,0,0,0,0,0,0,-19,0,0,0,-19,0,0,-10,-10,0,0,0,0,0,0,0,-20,0,0,0,0,20
0,0,0,20,0,0,0,-19,0,0,0,0,0,0,0,0,0,0,0,-10,-10,0,-10,15,9,9,9,9,9,9,9,9,16,0,-10,0,0,0,0,0,-20,0,0,0,0,20
0,0,0,19,0,0,15,9,16,-10,0,0,-11,player,0,-11,0,0,0,15,9,9,9,17,13,13,13,13,13,13,12,12,18,9,16,0,-10,0,0,0,-20,0,0,0,0,20
0,0,0,15,9,9,17,12,18,9,9,9,9,9,9,9,9,9,9,17,12,12,12,13,13,12,12,12,13,13,13,13,13,12,12,9,16,0,0,-10,-19,0,-10,-11,0,19,0,0,0,-10,0,0,0,0,0,0,0,0,0,0,0,0,0,0,0,0,0,0,0,0,0,0,0,0,0,0,0,0,0,0,0,0,0,0,0,0,0,0,0,0,0,0,0,0,0,0,0,0,0,0,0,0,0,0,0,0,0,0,0,0,0,0,0,0,0,0,0,0,0,0,0,0,0,0,0,0,0,0,0,0,0,0,0,0,0,0,0,0,0,0,0,0,0,0,0,0,0,0,0,0,0,0,0,0,0,0,0,0,0,0,0,0,0,0,0,0,0,0,0,0,0,0,0,0,0,0,0,0,0,0,0,0,0,0,0,0,0,0,0,0,0,0,0,0,0,0,0,0,0,0,0,0,0,0,9
0,15,9,17,13,13,12,12,12,12,12,12,12,12,12,12,12,12,12,12,14,14,14,14,29,29,13,13,12,12,12,12,13,13,12,12,18,9,9,9,9,9,9,9,9,9,9,9,9,9,9,9,9,9,9,9,9,9,9,9,9,9,9,9,9,9,9,9,9,9,9,9,9,9,9,9,9,9,9,9,9,9,9,9,9,9,9,9,9,9,9,9,9,9,9,9,9,9,9,9,9,9,9,9,9,9,9,9,9,9,9,9,9,9,9,9,9,9,9,9,9,9,9,9,9,9,9,9,9,9,9,9,9,9,9,9,9,9,9,9,9,9,9,9,9,9,9,9,9,9,9,9,9,9,9,9,9,9,9,9,9,9,9,9,9,9,9,9,9,9,9,9,9,9,9,9,9,9,9,9,9,9,9,9,9,9,9,9,9,9,9,9,9,9,9,9,9,9,9,9,9,9,9,9,9
9,17,12,12,13,13,13,13,13,13,14,14,14,14,14,14,14,14,14,14,29,29,29,29,29,29,29,14,13,13,13,13,13,13,13,13,13,13,12,13,13,13,13,12,12,12,12,12,13,12,12,12,12,12,12,13,13
14,14,14,14,14,14,14,14,14,14,29,29,29,29,29,29,29,29,29,29,29,29,29,29,29,29,29,29,29,14,13,13,13,14,14,14,13,13,13,13,13,13,12,12,12,12,12,12,12,13,13,13,13,13,13,13,13
29,29,29,29,29,29,29,29,29,29,29,29,29,29,29,29,29,29,29,29,29,29,29,29,29,29,29,29,29,29,14,14,14,29,29,29,14,14,14,14,13,13,13,13,13,13,13,13,13,13,13,13,13,13,14,14,14
0,0,0,0,0,0,0,0,0,0,0,0,0,0,0,0,0,0,0,0,0,0,0,0,29,29,29,29,29,29,29,29,29,29,29,29,29,29,29,29,14,14,14,14,14,14,14,14,14,14,14,14,14,14,29,29,29
0,0,0,0,0,0,0,0,0,0,0,0,0,0,0,0,0,0,0,0,0,0,0,0,0,0,0,0,0,0,0,0,0,0,0,0,0,0,29,29,29,29,29,29,29,29,29,29,29,29,29,29,29,29,29
0,0,0,0,0,0,0,0,0,0,0,0,0,0,0,0,0,0,0,0,0,0,0,0,0,0,0,0,0,0,0,0,0,0,0,0,0,0,0,0,29,29,29,29,29,29,29,29,29,29,29
